{
  "tile size": 100,
  "player spawn": [ 5, 3 ],
  "data": [
    [ 1, 1, 1, 1, 1, 1, 1, 1, 1, 1 ],
    [ 1, 0, 0, 0, 0, 1, 1, 0, 0, 1 ],
    [ 1, 0, 0, 0, 0, 0, 0, 0, 0, 1 ],
    [ 1, 0, 0, 0, 0, 0, 0, 0, 0, 1 ],
    [ 1, 0, 0, 0, 0, 1, 1, 0, 0, 1 ],
    [ 1, 1, 1, 1, 0, 1, 1, 0, 0, 1 ],
    [ 1, 0, 0, 1, 1, 1, 1, 0, 0, 1 ],
    [ 1, 0, 0, 0, 0, 0, 0, 0, 0, 1 ],
    [ 1, 0, 0, 1, 1, 1, 1, 1, 1, 1 ],
    [ 1, 1, 1, 1, 1, 1, 1, 1, 1, 1 ]
  ]
}